////////////////////////////////////////////////////////////////////
/                                                                  /
/                                                                  /
/                                   The mountains                  /
/                                                  /\              /
/                The                  /\  /       ///\             /
/                 Tipi   \/          /  \/ \ /\  /\/\/\            /
/    _       ___   City  /\         /   / O /  \/      \           /
/   / \     /   \       //\\       ______/ /   /                   /
/  /   \   /     \___X_           /                \                /
/ /_____\ /            \         /                  \               /
/  |   | /        /     \       /                    \              /
/  | O |-+      _(°)> ___X------|__                  _X             /
/  Home   \_  /<_/   /          |  \                /               /
/           \_      /   ()      \   \_X____        /                /
/             \____X   ( °)      \_        \_     /                 /
/                     ( )  )       \_         }__/        ||       /
/                      (  )          \       /         ___\/       /
/                       ||            \___X_/         /___|        /
/                       ||                           /    \        /
/                                                                  /
////////////////////////////////////////////////////////////////////

