////////////////////////////////////////////////////////////////////
/                                                                  /
/                                                                  /
/                                    5.La mine                     /
/                                                  /\              /
/                                     /\  /       ///\             /
/               3.Tipi   \/          /  \/ \ /\  /\/\/\            /
/    _       ___   City  /\         /   / O /  \/      \           /
/   / \     /   \       //\\       ______/ /   /                   /
/  /   \   /     \___X_           /                \               /
/ /_____\ /            \         /                  \              /
/  |   | /        /     \       /                    \             /
/  | O |-+      _(°)> ___X------|__                  _X Final      /
/1.Maison \_  /<_/   / 4.Marais |  \   Le chemin    /              /
/           \_      /   ()      \   \_X____        /               /
/             \____X   ( °)      \_        \__    /                /
/                     ( )  )       \_         }__/        ||       /
/             2.Foret  (  )          \       /         ___\/       /
/                       ||            \___X_/         /___|        /
/                       ||                Le cerf    /    \        /
/                                                                  /
////////////////////////////////////////////////////////////////////

